############################################################
#P..E.#.................#.......#.......#.....#.......#....#
#####.#.#.#############.#.###.#.#.#####.#.###.#.###.#.#.#.##
#...#.#.#.#...#.......#.#.#...#...#...#.#...#.#.#...#...#..#
#..'''''''='''''''''''#.###.#######.#.#.###.#.###.#######.## 
#.#...#...#.#.#.#...#.#...#.......#.#.#...#.#.....#........#
#.#####.###.#.#####.#####.#######.###.###.#.#######.########
#...#...#...#.....#.....#.........#...#...#...#...#.....#..#
###.#.###.#.#####.#.#.#############.#.#.#####.#.#######.#.##
#.#...#...#...#...#.#.#.............#.#.......#.......#.#..#
#.###########.#.###.#.#.#########.###############.#####.#.##
#.#.........#.#...#.#.#.....#...#.#.....#.#.......#...#''''= 
#.#.#.#####.#.###.###.#####.#.#.#.#.#.#.#.#.###.###.#.###.##
#...#...#.....#...........#...#.#...#.#.#.#.#.#.....#...#..#
#.#####.###########.###########.#####.#.#.#.#.#######.#.#.##
#...#.#.....#...#...#.....#.....#.#...#.#.#.........#.#.#..#
###.#.#####.#.#.#####.###.#.#####.#.###.#.###.#####.#.###.##
#.#...#...#...#.........#.#.#.....#...#.....#.#...#.#...#..#
#.###.#.#.###############.#.#.###.###.#####.#.#.#.###.#.#.##
#...#.#.#.......#.#.......#.#.#...#.#.....#.#.#.#...#.#.#..#
#.#.#.#.#.#####.#.#.#####.#.#.#.#.#.#####.#.#.#.###.###.#.##
#.#.#.#.#.#...#...#.#.....#.#.#.#.#.....#.#.#.#.#.......#..#
#.#.#.###.#.#####.#.#######.###.#.#.#.###.###.#.#.#######.##
#...''''''''''''''''''''''='''''''''''#...#...#.#...#......# 
#.#########.#############.###########.#.#.#.###.#####.######
#.......#...#.....#...#.....#.......#.#.#.#.#.#.......#....#
#.#####.#.###.#####.#.#.#####.#.#####.#.#.#.#.###########.##
#...#.#.....#...#...#.....#.....#...#.#...#...#............# 
='''''''''''''''''''''''''''''''''''''#.###.#####.######## 
#.#...#.#.#...#.....#.............#.....#.#...#...#........#
#.#.#.#.#.#########.###.#####.#####.#####.#.###.#.#.#####.##
#...#.#.......''''''''''''''''='''''''''''''''#.#.#.#......# 
#####.#.#######.#######.#.#.#.#.#.#.#.#####.###.#.#.#.###.##
#...#.#.......#.#.....#.#.#...#...''''''''''''''''''='''''## 
#.#.#.#####.###.#.###.###.#.###.#######.#.#.#.###.#.###.####
#.#.#.....#...#...#.#.....#...#...#.......#.#.#.#.#...#....#
#.#.#####.###.#####.#########.###.#########.#.#.#.###.###.##
#.#...#...'''''''''''''''''''''''''''''''''''''''''''='''''# 
#.###.#.#.#.#####.###.#.#.#.#.#.#.#.#####.#####.###.#####.##
#...#...#.#.....#.#.#.#...#.#...#.#.#...#.....#...#.#......#
#.#.#####.###.###.#.#.#####.###.#.#.#.#######.###.###.###.##
#.#.......#...#...#.#.#...#.#...#...#.......#...#.....#....#
#.#########.###.###.#.#.#.#.#.#########.#.#####.#######.####
#.....#...#...#...''''''''''''''''''='''''......#.#...#....# 
#####.#.###.#.#.###.#.#.###.#.#.#######.###.#####.#.#.###.##
#...#.#.....#.#...#.#...#...#.#...#.....#...#...#...#...#..#
#.###.#.#####.###.#.#####.###.#.#.#######.###.#.###.#####.##
#.....#.#.#.....#.......#...#.#.#.......#.....#.#...#......#
#.#####.#.#.###.#.###.#.###.#.#####.###.#######.#####.######
#.....#...#.#...#...#.#.....#.....#...#...#...#.....#......#
#####.#####.#.#####.#.###########.#####.#.#.#.#####.#####.##
#...#.......#.#...#.#...#.....#.#.......#.#.#...#.....#....#
#.#.#########.###.#.###.#.###.#.#########.###.#.#.#####.####
#.#.....#.#...#...#.#.#...#.#...#.......#.....#...'''''''''= 
#.#.###.#.#.###.#.#.#.#####.###.#.#############.#####.#.#.##
#.#.#.....#.#...#.#.#.............#...........#.#...#...#..#
#.#.#######.###.#.#.###############.#####.#####.#.#.####..##
#.#.............#.#.....................#.........#......D'#
#.#.#.#.#.#.#.#.#.#.#.#.#.#.#.#.#.#.#.#.#.#.#.#.#.#.#.#.#''E
############################################################ 