############################################################
#P...#..................................#..................#
#....#..................................#..................#
#....#..................................#..................#
#..E.#..................................#..................#
#....#####################....######....###########....#####
#....#........................#....#....#..................#
#....#........................#....#....#..................#
#....#........................#....#....#..................#
#....#........................#....#....#..................#
#....#....#####################....#....#....###############
='''''''''#.........#...................#..................#
#.........#'''''''''='''''''''''''''''''#..................#
#.........#.........#...................#..................#
#.........#.........#...................#''''''''''''''''''=
###########....#....#....################....######....#####
#....#.........#.........#....#...................#........#
#....#.........#.........#....#...................#........#
#....#.........#.........#....#...................#........#
#....#.........#.........#....#...................#........#
#....#....################....#....################....#####
#....#.........#..............#....#....#..................#
#....#.........#..............#....#....#..................#
#....#.........#..............#....#....#..................#
#....#.........#''''''''''''''=''''#....#..................#
#....######....#....#....######....#....#....######....#####
#.........#....#....#....#.........#....#.........#........#
#.........#....#....#....#.........#....#.........#........#
#.........#....#....#....#.........#....#.........#........#
#.........#....#....#....#.........#....#.........#........#
#....#....#....#....#....#....######....######....#....#####
#....#....#....#....#....#..............#.........#........#
#....#....#....#....#....#..............#.........#........#
#....#....#....#....#....#..............#.........#........#
#....#....#....#....#....#..............#.........#........#
#....#....#....#....#....###########....#....###############
#....#.........#....#...................#..................#
#....#.........#....#...................#..................#
#....#.........#....#...................#..................#
#....#.........#....#'''''''''''''''''''=''''''''''''''''''#
#....####################################....######....#####
#.........#.............................#.........#........#
#.........#.............................#.........#........#
#.........#.............................#.........#........#
#.........#.............................#.........#........#
######....#....#####################....#....######....#####
#.........#....#...................#....#....#.............#
#.........#....#...................#....#....#....#........#
#.........#....#...................#....#....#....#........#
#.........#....#...................#....#....#....#........#
#....######....#....#....###########....######....###D######
#..............#....#.............................#''''''''#
#..............#....#.............................#''''''''#
#..............#....#.............................#''''''''#
#..............#....#.............................#''''''''#
#....#....#....#....#....#....#....#....#....#....#''''''''#
#....#....#....#....#....#....#....#....#....#....#''''''''#
#....#....#....#....#....#....#....#....#....#....#''''''''#
#....#....#....#....#....#....#....#....#....#....#''''''''E
############################################################
