############################################################
#P...#.....................................................#
#....#..................................#..................#
#....#....##########################....################...#
#....#.............................#....#....#.........#...#
#....######....######....######....######....#.###.....#...#
#..............#....#....#....#..............#...#.....#...#
#..............#..............#..............#...#.....#...#
#....######....#....#....#....#....######....#...#.....#...#
#....#....#....######....######....#....#....#...#.....#...#
#....#....#........................#....#....#####.....#...#
='''''''''#.........######.........#....#..............#...#
#....#....#'''''''''=''''''''''''''#....#..............#...#
#....#....#.........######.........#....################...#
#.........#........................#.......................#
###########....######....######....#####################...#
#....#.........#....#....#....#...................#........#
#....#.........#....#....#....#...................#........#
#....#....######....######....######....###########........#
#....#....#........................#....#..................#
#....######....#####################....#....###############
#..............#........................#....#.............#
#..............#........................######.............#
#....######....#....#################......................#
#....#....#....#....#'''''''''''''''=''''''''''''''''''''''#
#....#....######....#....##....######...####################
#....#..............#....#..........#...#..................#
#....#..............#....#..........#...#..................#
#....################....#....######....#....###############
#........................#....#.........#....#.............#
#........................#....#.........#....#.............#
#....#####################....#....######....#....##########
#....#........................#....#.........#.............#
#....#........................#....#.........#.............#
#....#....#####################....#....################...#
#....#....#........................#.......................#
#....######....#####################....################...#
#..............#...................#....#..............#...#
#..............#...................#....#..............#...#
#....###########'''''''''''''''''''='''''''''''''''''''#...#
#....#.........#####################....############...#...#
#....#.........#........................#..........#...#...#
#....######....#........................#....#..#..#...#...#
#.........#....#........................#....#..#..#...#...#
#.........#....#####################....######..#..#...#...#
######....#........................#............#..#...#...#
#.........#........................#............#..#...#...#
#.........#####################....##############..#...#...#
#.............................#....................#...#...#
#.............................#....................#...#...#
#....#####################....######################...###D#
#....#...................#.............................#'''#
#....#...................#.............................#'''#
#....#....###########....#.............................#'''#
#....#....#.........#....#.............................#'''#
#....######....######....#....#....#....#....#....#....#'''#
#..............#.........#....#....#....#....#....#....#'''#
#..............#.........#....#....#....#....#....#....#'''#
#........................#....#....#....#....#....#....#'''E
############################################################